/Affirmative01.vcd	Affirmative!
/Affirmative02.vcd	Yes!
/Affirmative03.vcd	Affirmative.
/Agree01.vcd	Agreed.
/Agree02.vcd	I agree.
/Agree03.vcd	Of course.
/Agree04.vcd	Yes, yes, yes.
/Agree06.vcd	Dah.
/Agree07.vcd	Understood.
/Blinded01.vcd	I'm blind!
/Blinded05.vcd	Can't see!
/Blinded06.vcd	Blinded!
/BombTickingDown01.vcd	It is going to explode!
/BombTickingDown02.vcd	We are going to win!
/BombTickingDown03.vcd	We are going to do this!
/BombTickingDown04.vcd	They cannot stop us now!
/BombTickingDown05.vcd	The Bomb is ticking down!
/Clear01.vcd	All clear.
/Clear02.vcd	Clear!
/Clear03.vcd	Clear.
/ClearedArea01.vcd	No one is here.
/ClearedArea02.vcd	This area is clear.
/ClearedArea03.vcd	They're not here.
/CoveringFriend01.vcd	I have your back.
/CoveringFriend02.vcd	I'll cover you.
/CoveringFriend03.vcd	I'm covering you.
/CoverMe01.vcd	Cover me!
/CoverMe02.vcd	Watch my back.
/CoverMe03.vcd	Cover me.
/DefendingBombsiteA01.vcd	Watching Bombsite A.
/DefendingBombsiteA02.vcd	Covering Bombsite A.
/DefendingBombsiteA03.vcd	Staying at Bombsite A.
/DefendingBombsiteA04.vcd	Guarding A.
/DefendingBombsiteB01.vcd	Watching Bombsite B.
/DefendingBombsiteB02.vcd	Covering Bombsite B.
/DefendingBombsiteB03.vcd	Staying in Bombsite B.
/DefendingBombsiteB04.vcd	Guarding B.
/DefendingBombsiteB05.vcd	I will stay at Bombsite B.
/Disagree01.vcd	No.
/Disagree02.vcd	I disagree.
/Disagree03.vcd	I would not agree.
/Disagree05.vcd	I disagree.
/Disagree06.vcd	That is not correct.
/EnemyDown01.vcd	He's down.
/EnemyDown02.vcd	I got one.
/EnemyDown03.vcd	Got 'em!
/EnemyDown04.vcd	Yes!
/EnemyDown05.vcd	I got 'em.
/EnemyDown06.vcd	I hit him.
/EnemyDown07.vcd	Take that!
/EnemyDown08.vcd	He's down!
/EnemyDown09.vcd	Got one!
/FollowingFriend01.vcd	You lead the way.
/FollowingFriend02.vcd	Go, I'm with you.
/FollowingFriend03.vcd	Lead the way!
/FollowingFriend04.vcd	You lead.
/FollowingFriend05.vcd	Lead the way.
/FriendlyFire01.vcd	Do not shoot me!
/FriendlyFire02.vcd	Are you stupid?!
/FriendlyFire03.vcd	Stop shooting me!
/FriendlyFire04.vcd	You're shooting me!
/FriendlyFire05.vcd	Stop! You're shooting me!
/FriendlyFire06.vcd	Don't make me shoot you back!
/FriendlyFire07.vcd	I am not the enemy!
/GoingToDefendBombsite01.vcd	I'll guard the Bombsite.
/GoingToDefendBombsite02.vcd	Going to the Bombsite.
/GoingToDefendBombsite03.vcd	I will go defend the Bombsite.
/GoingToDefendBombsite04.vcd	Going to defend the Bombsite.
/GoingToGuardHostageEscapeZone01.vcd	I'll guard their Escape.
/GoingToGuardHostageEscapeZone02.vcd	I'm heading to their Escape Area.
/GoingToGuardHostageEscapeZone03.vcd	I'll surprise them at their Escape Area.
/GoingToPlantBomb01.vcd	Going to plant the Bomb.
/GoingToPlantBomb02.vcd	I am going to plant the Bomb!
/GoingToPlantBomb03.vcd	I'll plant the Bomb.
/GoingToPlantBombA01.vcd	Taking the Bomb to A.
/GoingToPlantBombA02.vcd	I'm going to plant the Bomb at A.
/GoingToPlantBombA03.vcd	I'm taking the Bomb to A.
/GoingToPlantBombB01.vcd	I'm going to plant the Bomb at B.
/GoingToPlantBombB02.vcd	I'm taking the Bomb to B.
/HeardNoise01.vcd	Did you hear that?
/HeardNoise02.vcd	What was that noise?
/HeardNoise03.vcd	I think I heard something.
/HeardNoise05.vcd	I think I heard someone.
/help01.vcd	I need help here!
/help02.vcd	Get over here and need help!
/help03.vcd	Help!
/help04.vcd	I need help!
/help05.vcd	Need help!
/InCombat01.vcd	Attacking!
/InCombat02.vcd	I'm going to kill them all!
/InCombat03.vcd	Opening fire.
/InCombat04.vcd	I'm attacking!
/InCombat05.vcd	I'm firing!
/InCombat06.vcd	You will all die!
/InCombat07.vcd	Take this.
/InCombat08.vcd	You are going to die.
/InCombat09.vcd	You are all going to die.
/InCombat10.vcd	Every last one of you is going to die.
/InPosition01.vcd	I'm in position.
/InPosition02.vcd	I'm ready.
/InPosition03.vcd	I'm prepared.
/KilledFriend01.vcd	What is going on?
/KilledFriend02.vcd	Do not kill our friends!
/KilledFriend03.vcd	Stop! You have killed your own.
/KilledFriend04.vcd	Are you crazy?! Stop!
/KilledFriend05.vcd	What are you doing?!
/LastManStanding01.vcd	I have won!
/LastManStanding02.vcd	I'm victorious!
/LastManStanding03.vcd	You did not kill me!
/LastManStanding04.vcd	I live!
/LastManStanding05.vcd	You will never kill me!
/LastManStanding06.vcd	I'm still alive!
/LastManStanding07.vcd	I have killed you all!
/LostEnemy01.vcd	I've lost them.
/LostEnemy02.vcd	They've gotten away.
/LostEnemy03.vcd	I lost them.
/LostEnemy04.vcd	They've escaped me.
/Negative01.vcd	Negative.
/Negative02.vcd	No.
/Negative03.vcd	No, no, no, no.
/Negative04.vcd	Ah ah.
/NegativeNo05.vcd	Нет. (No.)
/NiceShot01.vcd	Good shot.
/NiceShot02.vcd	Good shooting!
/NiceShot03.vcd	Very good.
/NiceShot04.vcd	Very nice.
/NiceShot05.vcd	Nice shot!
/NiceShot06.vcd	Nice shooting.
/NiceShot07.vcd	Nice shot, nice shot.
/NiceShot08.vcd	You got him!
/NiceShot09.vcd	Nice! Nice!
/NiceShot10.vcd	You killed him.
/NiceShot11.vcd	Leave some for me!
/NiceShot12.vcd	You killed one.
/NiceShot13.vcd	Very good.
/OnARollBrag01.vcd	Yeees!
/OnARollBrag02.vcd	You are stupid to think you will win.
/OnARollBrag03.vcd	yes, Yes, YES!
/OnARollBrag04.vcd	You think you can kill us?!
/OnARollBrag05.vcd	We cannot be killed!
/OnARollBrag06.vcd	Fear us!
/OnARollBrag07.vcd	You will all die.
/OnARollBrag08.vcd	I fear no man!
/OnARollBrag09.vcd	Hahaha, we are the best!
/OnARollBrag10.vcd	We will stomp you all!
/OnARollBrag11.vcd	Run little girls, RUN!
/OnARollBrag12.vcd	Fear us!
/OnARollBrag13.vcd	Where are the real men?!
/OnARollBrag14.vcd	You will cry like babies before you die.
/OnARollBrag15.vcd	We will dance on your graves.
/OneEnemyLeft04.vcd	Only one left.
/OneEnemyLeft05.vcd	1 man left.
/OneEnemyLeft06.vcd	Only one man left.
/OneEnemyLeft08.vcd	Let's kill the last one.
/OneEnemyLeft10.vcd	1 idiot left.
/OneEnemyLeft11.vcd	1 stupid man left.
/OneEnemyLeft12.vcd	1 left. Let's kill him already.
/OnMyWay01.vcd	I'm on my way.
/OnMyWay02.vcd	On my way.
/OnMyWay03.vcd	Coming.
/OnMyWay04.vcd	Heading that way.
/PepTalk01.vcd	We can do this.
/PepTalk02.vcd	This is where we get our revenge!
/PepTalk03.vcd	We must fight!
/PepTalk07.vcd	On to victory!
/PinnedDown01.vcd	I'm pinned!
/PinnedDown02.vcd	I'm under fire!
/PinnedDown03.vcd	They have me pinned!
/PlantingBomb01.vcd	Planting.
/PlantingBomb02.vcd	I am planting the Bomb.
/PlantingBomb03.vcd	I'm planting!
/PlantingBomb04.vcd	Activating the Bomb.
/Radio_EnemySpotted01.vcd	There is one.
/Radio_EnemySpotted02.vcd	I see them.
/Radio_EnemySpotted03.vcd	I can see them.
/Radio_EnemySpotted04.vcd	I see 'em, let's kill them.
/Radio_FollowMe01.vcd	Follow me!
/Radio_FollowMe02.vcd	This way.
/Radio_FollowMe03.vcd	Let's go this way.
/Radio_FollowMe04.vcd	You! Follow me.
/Radio_FollowMe05.vcd	Come follow me.
/Radio_FollowMe06.vcd	I'll lead the way.
/radio_letsgo01.vcd	Go go go!
/radio_letsgo02.vcd	Let's go!
/radio_letsgo03.vcd	Move it! MOVE IT!
/radio_letsgo04.vcd	Fall out!
/radio_letsgo05.vcd	Let's go my brothers.
/radio_letsgo06.vcd	Come on, come on, let's go.
/radio_letsgo07.vcd	Let's go.
/radio_letsgo08.vcd	We must move.
/radio_letsgo09.vcd	Let's go! Let's go!
/radio_locknload01.vcd	We must win.
/radio_locknload02.vcd	Together we can do this.
/radio_locknload03.vcd	We must work together.
/radio_locknload04.vcd	Let us go.
/radio_locknload05.vcd	We will make them regret this day.
/radio_locknload06.vcd	It is time now my brothers.
/radio_locknload07.vcd	Now is the time.
/radio_locknload08.vcd	No more talking, now we fight.
/radio_locknload09.vcd	This is our fight.
/radio_locknload10.vcd	This is what we have been working for.
/radio_locknload11.vcd	Guys I tell you, we kill them all!
/radio_locknload12.vcd	This is easy, we kill them and then we go home.
/Radio_NeedBackup01.vcd	Need backup.
/Radio_NeedBackup02.vcd	I need backup!
/Radio_NeedBackup03.vcd	Need backup!
/Radio_NeedBackup05.vcd	I'm being overrun!
/Radio_NeedBackup06.vcd	Too many of them for me.
/Radio_TakingFire01.vcd	I'm under fire.
/Radio_TakingFire02.vcd	They're shooting at me!
/Radio_TakingFire03.vcd	They want to kill me!
/Radio_TakingFire04.vcd	They're firing at me!
/Radio_TakingFire05.vcd	They're trying to kill me!
/Radio_TakingFire06.vcd	They're shooting at me!
/RadioBotEndClean01.vcd	We defeated them!
/RadioBotEndClean02.vcd	We all survived!
/RadioBotEndClean03.vcd	This is our victory!
/RadioBotEndClean04.vcd	We have done it!
/RadioBotEndClean05.vcd	We have done it, my friends!
/RadioBotEndClean06.vcd	They didn't send the real men!
/RadioBotEndClean07.vcd	It's like they not even try!
/RadioBotEndClean08.vcd	They didn't put up a fight!
/RadioBotEndSolid01.vcd	We have destroyed them!
/RadioBotEndSolid02.vcd	We have our revenge!
/RadioBotEndSolid03.vcd	We have done it!
/RadioBotEndSolid04.vcd	It's over.
/RadioBotEndSolid05.vcd	We have defeated them!
/RadioBotEndSolid06.vcd	That was a win.
/RadioBotFallBack01.vcd	Get back.
/RadioBotFallBack02.vcd	Back, back, back!
/RadioBotFallBack03.vcd	Back! Back!
/RadioBotHold01.vcd	Hold here.
/RadioBotHold02.vcd	Cover this area.
/RadioBotHold03.vcd	Guard this area.
/RadioBotRegroup01.vcd	Stay together.
/RadioBotRegroup02.vcd	Everyone together.
/RadioBotRegroup03.vcd	Regroup.
/ReportingIn01.vcd	I'm here.
/ReportingIn02.vcd	Here!
/ReportingIn03.vcd	Here.
/ReportingIn04.vcd	Here, what do you want?
/RequestReport01.vcd	What is happening?
/RequestReport02.vcd	What do you see?
/RequestReport03.vcd	Check in.
/ScaredEmote01.vcd	This is not going well.
/ScaredEmote02.vcd	What is happening?
/ScaredEmote03.vcd	We're falling apart!
/ScaredEmote04.vcd	You are all idiots.
/ScaredEmote05.vcd	No.. No, no!
/ScaredEmote06.vcd	I do not like this.
/ScaredEmote07.vcd	This is no good.
/ScaredEmote08.vcd	We must stop fighting!
/SniperKilled01.vcd	Sniper is down.
/SniperKilled02.vcd	Sniper down.
/SniperKilled03.vcd	I have gotten Sniper.
/SniperKilled04.vcd	Sniper is dead.
/SniperWarning01.vcd	Sniper.
/SniperWarning02.vcd	Watch out, Sniper!
/SniperWarning03.vcd	Sniper!
/SpottedLooseBomb01.vcd	We drop the Bomb.
/SpottedLooseBomb02.vcd	We lost the Bomb.
/SpottedLooseBomb03.vcd	Get the Bomb!
/SpottedLooseBomb04.vcd	We've dropped the Bomb.
/SpottedLooseBomb05.vcd	The Bomb is on the ground.
/SpottedLooseBomb06.vcd	Someone must recover the Bomb.
/t_death01.vcd	Grmphaa.!
/t_death02.vcd	Uhmph...!
/t_death03.vcd	Gr..ahh.!
/t_death04.vcd	Uah..a..!
/t_death05.vcd	Grpmh...!
/t_decoy01.vcd	Decoy!
/t_decoy02.vcd	Decoy's out.
/t_decoy03.vcd	Throwing a decoy.
/t_flashbang01.vcd	Flashbang!
/t_flashbang02.vcd	Throwing Flashbang!
/t_flashbang03.vcd	I'm throwing a Flashbang!
/t_grenade02.vcd	Grenade out.
/t_grenade04.vcd	Grenade!
/t_grenade05.vcd	I'm throwing a Grenade!
/t_molotov01.vcd	Throwing fire!
/t_molotov02.vcd	Molotov!
/t_molotov03.vcd	Molotov!
/t_molotov04.vcd	Throwing fire!
/t_molotov05.vcd	I'm throwing fire!
/t_molotov07.vcd	Burn!
/t_smoke01.vcd	Throwing Smoke!
/t_smoke02.vcd	Smoke!
/t_smoke03.vcd	Smoke out!
/Thanks01.vcd	Thank you.
/Thanks02.vcd	Thank you, brother.
/Thanks04.vcd	Thanks.
/ThreeEnemiesLeft01.vcd	3 left.
/ThreeEnemiesLeft02.vcd	That makes three left.
/ThreeEnemiesLeft04.vcd	3 men left.
/ThreeEnemiesLeft05.vcd	3 units left.
/TwoEnemiesLeft01.vcd	Down to two.
/TwoEnemiesLeft02.vcd	Only two men left.
/TwoEnemiesLeft03.vcd	2 men left.
/TwoEnemiesLeft04.vcd	That makes two left.
/TwoEnemiesLeft05.vcd	That makes two.
/WaitingHere01.vcd	I'm waiting here.
/WaitingHere02.vcd	I'll wait here.
/WaitingHere03.vcd	I'll stay here.