/Affirmative01.vcd	Yes.
/Affirmative02.vcd	Affirmative.
/Affirmative03.vcd	Agreed.
/Agree04.vcd	I agree.
/Agree05.vcd	Of course.
/Agree06.vcd	That is the plan.
/Blinded01.vcd	I'm blind!
/Blinded03.vcd	Blinded.
/Blinded04.vcd	Blinded!
/BombTickingDown01.vcd	It is going to explode.
/BombTickingDown02.vcd	We are going to do this.
/BombTickingDown03.vcd	They will not stop the bomb now!
/BombTickingDown05.vcd	Get ready! It is going to explode.
/Clear01.vcd	All clear.
/Clear02.vcd	No one here.
/ClearedArea01.vcd	No one is here.
/ClearedArea02.vcd	They are not here
/ClearedArea03.vcd	They are not here!
/CoveringFriend01.vcd	I shall cover you.
/CoveringFriend02.vcd	My friend, you are covered.
/CoveringFriend03.vcd	I have your back.
/CoverMe01.vcd	Watch my back.
/CoverMe02.vcd	Cover me.
/DefendingBombsiteA01.vcd	Watching Bombsite A.
/DefendingBombsiteA02.vcd	Covering Bombsite A.
/DefendingBombsiteA03.vcd	Staying at Bombsite A.
/DefendingBombsiteA04.vcd	Guarding A.
/DefendingBombsiteB01.vcd	Watching Bombsite B.
/DefendingBombsiteB02.vcd	Covering Bombsite B.
/DefendingBombsiteB03.vcd	Staying at Bombsite B.
/DefendingBombsiteB04.vcd	Guarding B.
/DefendingBombsiteB05.vcd	I will stay at Bombsite B.
/Disagree01.vcd	No.
/Disagree02.vcd	I disagree.
/Disagree03.vcd	I would not agree.
/Disagree04.vcd	That is not right.
/EnemyDown01.vcd	He's down!
/EnemyDown02.vcd	I got one!
/EnemyDown03.vcd	Got 'em!
/EnemyDown04.vcd	It is over for him!
/EnemyDown05.vcd	That's his last!
/EnemyDown06.vcd	I hit him!
/EnemyDown07.vcd	One less!
/EnemyDown08.vcd	I killed him!
/FollowingFriend01.vcd	You lead the way.
/FollowingFriend02.vcd	I am with you.
/FollowingFriend03.vcd	Go, I will follow.
/FollowingFriend04.vcd	You lead.
/FollowingFriend05.vcd	Lead the way my friend.
/FriendlyFire01.vcd	Do not shoot me!
/FriendlyFire03.vcd	What are you doing?
/FriendlyFire04.vcd	You are shooting me!
/FriendlyFire06.vcd	Save those bullets!
/FriendlyFire07.vcd	I fear your bullets more than our enemy's!
/FriendlyFire08.vcd	Stop shooting me!
/GoingToDefendBombsite01.vcd	Guarding the Bombsite.
/GoingToDefendBombsite02.vcd	I will watch the Bombsite.
/GoingToDefendBombsite03.vcd	Staying at the Bombsite.
/GoingToDefendBombsite05.vcd	I shall go stay with the Bomb.
/GoingToGuardHostageEscapeZone01.vcd	I'll guard their Escape.
/GoingToGuardHostageEscapeZone02.vcd	I'm heading to their Escape Area.
/GoingToGuardHostageEscapeZone03.vcd	I'll surprise them at their Escape Area.
/GoingToGuardHostages01.vcd	Going to guard the Hostages.
/GoingToGuardHostages02.vcd	I'll protect Hostages.
/GoingToGuardHostages03.vcd	I'll stay with the Hostages.
/GoingToGuardHostages04.vcd	Heading to the Hostages.
/GoingToPlantBomb01.vcd	Going to plant the Bomb.
/GoingToPlantBomb02.vcd	I am going to plant the Bomb.
/GoingToPlantBomb03.vcd	I will plant the Bomb.
/GoingToPlantBombA01.vcd	Taking the Bomb to A.
/GoingToPlantBombA02.vcd	I am going to plant the Bomb at A.
/GoingToPlantBombA03.vcd	I am taking the bomb to A.
/GoingToPlantBombB01.vcd	I am going to plant the Bomb at B.
/GoingToPlantBombB02.vcd	Taking the Bomb to B.
/GuardingHostageEscapeZone01.vcd	I am guarding against their Escape.
/GuardingHostageEscapeZone02.vcd	I am blocking their Escape.
/GuardingHostageEscapeZone03.vcd	I will guard against their Escape.
/GuardingHostages01.vcd	I am staying with the Hostages.
/GuardingHostages02.vcd	The Hostages are with me.
/GuardingHostages03.vcd	The Hostages will be safe with me.
/GuardingHostages04.vcd	I am at the Hostages.
/GuardingHostages05.vcd	I am with the Hostages.
/HeardNoise01.vcd	What was that noise?
/HeardNoise02.vcd	I think I heard something.
/HeardNoise03.vcd	Did you hear that?
/help01.vcd	Ahhh! I need help here!
/help02.vcd	Help!
/help03.vcd	I need help!
/help04.vcd	Where is everyone?!
/InCombat01.vcd	I am returning fire!
/InCombat02.vcd	I am making this right!
/InCombat03.vcd	Attacking!
/InCombat04.vcd	I will kill you.
/InCombat05.vcd	I'm attacking.
/InCombat06.vcd	Fear me!
/InPosition01.vcd	I'm in position.
/InPosition02.vcd	I'm ready.
/InPosition03.vcd	I'm prepared.
/KilledFriend01.vcd	What is going on?!
/KilledFriend02.vcd	Do not kill our friends!
/KilledFriend03.vcd	Stop. You have killed our own!
/LastManStanding01.vcd	I have triumphed!
/LastManStanding03.vcd	I alone am victorious!
/LastManStanding04.vcd	You have been slaughtered.
/LastManStanding06.vcd	I am still alive.
/LastManStanding07.vcd	I fear no man!
/LastManStanding08.vcd	I have driven you out.
/LostEnemy01.vcd	I've lost them.
/LostEnemy02.vcd	They have gotten away!
/LostEnemy03.vcd	I do not see them anymore.
/Negative01.vcd	Negative.
/Negative02.vcd	No, my friend.
/Negative03.vcd	No.
/Negative04.vcd	Uh uh.
/NegativeNo03.vcd	I must say no.
/NegativeNo04.vcd	Of course not.
/NiceShot02.vcd	Very good shooting.
/NiceShot03.vcd	Very good shot.
/NiceShot04.vcd	Very good.
/NiceShot05.vcd	Very nice!
/NiceShot06.vcd	Nice shot!
/NiceShot07.vcd	Nice shooting!
/NiceShot08.vcd	Nice shot, my friend!
/NiceShot09.vcd	You got him!
/NiceShot10.vcd	You have done well!
/NiceShot11.vcd	With your will we shall drive them out.
/NiceShot12.vcd	1 less mercenary thanks to you!
/OnARollBrag01.vcd	Yes!
/OnARollBrag02.vcd	We will be victorious!
/OnARollBrag03.vcd	Yes my friends, YES!
/OnARollBrag04.vcd	The world is ours.
/OnARollBrag05.vcd	Our enemies tremble!
/OnARollBrag06.vcd	Our guns shall bring us victory!
/OnARollBrag07.vcd	We shall overcome!
/OnARollBrag08.vcd	Victory is ours!
/OnARollBrag09.vcd	We shall slaughter our enemies!
/OnARollBrag10.vcd	We will live long lives!
/OnARollBrag11.vcd	We fear no one!
/OnARollBrag12.vcd	We have arrived!
/OneEnemyLeft02.vcd	Only one man left.
/OneEnemyLeft03.vcd	We one left against us.
/OneEnemyLeft05.vcd	Only one man left.
/OneEnemyLeft06.vcd	One still opposes us.
/OneEnemyLeft07.vcd	1 left.
/OneEnemyLeft10.vcd	1 mercenary left wasting our time.
/OnMyWay01.vcd	I am on my way.
/OnMyWay02.vcd	On my way.
/OnMyWay03.vcd	Coming.
/PepTalk01.vcd	We can do this!
/PepTalk03.vcd	We cannot let them win!
/PepTalk04.vcd	We must fight to our last!
/PepTalk07.vcd	Let us decide our own fate, brothers!
/PinnedDown01.vcd	I am pinned!
/PinnedDown02.vcd	I am under fire!
/PinnedDown03.vcd	They have me pinned!
/PinnedDown04.vcd	Help!
/PlantingBomb01.vcd	Planting.
/PlantingBomb02.vcd	I am planting the Bomb.
/Radio_EnemySpotted02.vcd	I see them.
/Radio_EnemySpotted03.vcd	I can see them.
/Radio_EnemySpotted04.vcd	I see our enemy.
/Radio_EnemySpotted05.vcd	I see a mercenary.
/Radio_EnemySpotted06.vcd	I see 'em, shall I open fire?
/Radio_FollowMe02.vcd	This way.
/Radio_FollowMe03.vcd	Let us go this way.
/Radio_FollowMe04.vcd	Follow me, my friend.
/Radio_FollowMe06.vcd	I will lead the way.
/radio_letsgo01.vcd	Go go go!
/radio_letsgo02.vcd	Move it! Move it!
/radio_letsgo03.vcd	Forward!
/radio_letsgo04.vcd	Let's go, my brothers!
/radio_letsgo05.vcd	Come on, let's go!
/radio_letsgo06.vcd	Let's go, victory awaits!
/radio_letsgo07.vcd	To victory!
/radio_letsgo08.vcd	Let's go!
/radio_letsgo09.vcd	We must move!
/radio_letsgo10.vcd	Let's go, let's go!
/radio_letsgo11.vcd	Let's go! Let's go!
/radio_letsgo12.vcd	Move! My brothers.
/radio_letsgo13.vcd	Move, my brothers! Move!
/radio_locknload01.vcd	So that we may be free.
/radio_locknload02.vcd	We will defeat the mercenaires.
/radio_locknload03.vcd	Be safe, let's go my friends.
/radio_locknload04.vcd	Take care of yourselves.
/radio_locknload05.vcd	Let us go.
/radio_locknload06.vcd	We will make them cry.
/radio_locknload07.vcd	We will defeat the mercenaries!
/radio_locknload08.vcd	We will drive them from our lands.
/radio_locknload09.vcd	We shall rule the day.
/radio_locknload10.vcd	They shall regret this day.
/Radio_NeedBackup01.vcd	I need more men!
/Radio_NeedBackup02.vcd	I need back-up!
/Radio_NeedBackup03.vcd	I'm outmatched!
/Radio_NeedBackup04.vcd	I'm being overrun!
/Radio_TakingFire01.vcd	I am under fire!
/Radio_TakingFire02.vcd	I have found them!
/Radio_TakingFire03.vcd	They are shooting at me!
/Radio_TakingFire04.vcd	They are firing at me!
/Radio_TakingFire05.vcd	I'm taking fire!
/Radio_TakingFire06.vcd	They are going to kill me!
/Radio_TakingFire07.vcd	They are shooting at me!
/RadioBotEndClean01.vcd	We defeated the mercenaries.
/RadioBotEndClean02.vcd	We all survived, my brothers.
/RadioBotEndClean03.vcd	Victory is ours!
/RadioBotEndClean04.vcd	We slaughtered our enemies!
/RadioBotEndClean05.vcd	We are in full control!
/RadioBotEndClean06.vcd	Today was our day!
/RadioBotEndSolid01.vcd	Our will brought us victory.
/RadioBotEndSolid02.vcd	Remember this day, my friends.
/RadioBotEndSolid03.vcd	We will remember this day.
/RadioBotEndSolid04.vcd	It is over.
/RadioBotEndSolid05.vcd	Each day we grow stronger.
/RadioBotEndSolid06.vcd	We have defeated the enemy.
/RadioBotFallBack01.vcd	Get back!
/RadioBotFallBack02.vcd	Back! Back!
/RadioBotFallBack04.vcd	Move back, move back!
/RadioBotHold01.vcd	Hold here.
/RadioBotHold02.vcd	Cover this area.
/RadioBotHold03.vcd	Guard this area.
/RadioBotRegroup01.vcd	Let us stay together.
/RadioBotRegroup02.vcd	Let us regroup.
/RadioBotRegroup03.vcd	Stick together.
/ReportingIn01.vcd	I am here, brothers.
/ReportingIn02.vcd	Here.
/ReportingIn03.vcd	Yes?
/RequestReport01.vcd	What do you see?
/RequestReport02.vcd	What is happening?
/RequestReport03.vcd	Check in.
/RequestReport04.vcd	Are you there?
/ScaredEmote01.vcd	This is not going well.
/ScaredEmote02.vcd	We are losing control!
/ScaredEmote03.vcd	We are losing control.
/ScaredEmote04.vcd	I don't know what to do!
/ScaredEmote05.vcd	Who will protect me?
/ScaredEmote07.vcd	Ayy!
/SniperKilled01.vcd	The Sniper is down.
/SniperKilled02.vcd	Sniper is down.
/SniperKilled03.vcd	I have gotten the Sniper!
/SniperKilled04.vcd	Sniper is no more.
/SniperWarning01.vcd	Sniper!
/SniperWarning02.vcd	Watch out, Sniper!
/SniperWarning03.vcd	Sniper!
/SniperWarning04.vcd	There is a sniper here!
/SpottedLooseBomb01.vcd	We have dropped the Bomb.
/SpottedLooseBomb02.vcd	The bomb is on the ground.
/SpottedLooseBomb03.vcd	We need that Bomb.
/SpottedLooseBomb04.vcd	Someone must recover the Bomb!
/SpottedLooseBomb05.vcd	We've lost the Bomb!
/SpottedLooseBomb06.vcd	We've dropped the Bomb!
/SpottedLooseBomb07.vcd	Get the Bomb!
/t_death01.vcd	Ahh..!
/t_death02.vcd	(exhale)
/t_death03.vcd	Ohh..!
/t_decoy01.vcd	Decoy!
/t_decoy02.vcd	Throwing a decoy.
/t_decoy03.vcd	Decoy's out!
/t_flashbang01.vcd	Flashbang!
/t_flashbang03.vcd	Throwing a Flashbang!
/t_flashbang04.vcd	I'm throwing a Flashbang!
/t_grenade01.vcd	Grenade!
/t_grenade02.vcd	I'm throwing a grenade.
/t_grenade03.vcd	Grenade!
/t_grenade05.vcd	Grenade!
/t_molotov01.vcd	Molotov!
/t_molotov02.vcd	Throwing fire!
/t_molotov04.vcd	Throwing fire.
/t_molotov05.vcd	Burn!
/t_smoke01.vcd	Smoke!
/t_smoke02.vcd	Smoke!
/t_smoke03.vcd	I'm throwing smoke.
/Thanks01.vcd	Thank you.
/Thanks02.vcd	Thank you, my friend.
/Thanks03.vcd	With much thanks.
/Thanks04.vcd	Shukran. (Thanks.)
/ThreeEnemiesLeft01.vcd	3 left.
/ThreeEnemiesLeft02.vcd	That makes three left.
/ThreeEnemiesLeft03.vcd	That makes three.
/ThreeEnemiesLeft05.vcd	3 mercenaries left.
/tmap_cs_italy01.vcd	Middle.
/tmap_cs_italy02.vcd	At the Middle.
/tmap_cs_office01.vcd	Snipers Nest.
/tmap_cs_office02.vcd	I'm checking that Snipers Nest.
/tmap_cs_office03.vcd	I'm in the Snipers Nest.
/tmap_cs_office04.vcd	Stairwell.
/tmap_cs_office05.vcd	Covering the Stairwell.
/tmap_cs_office06.vcd	In the Stairwell.
/tmap_cs_source01.vcd	'A' Ramp.
/tmap_cs_source02.vcd	At A Ramp.
/tmap_cs_source03.vcd	Checking the A Ramp.
/tmap_cs_source07.vcd	B Doors.
/tmap_cs_source08.vcd	Checking the B Doors.
/tmap_cs_source09.vcd	At B Doors.
/tmap_cs_source10.vcd	B Platform.
/tmap_cs_source11.vcd	Checking the B Platform.
/tmap_cs_source12.vcd	At B Platform.
/tmap_cs_source13.vcd	Catwalk.
/tmap_cs_source14.vcd	Checking the Catwalk.
/tmap_cs_source15.vcd	At Catwalk.
/tmap_cs_source22.vcd	Extended A.
/tmap_cs_source23.vcd	Checking the Extended A.
/tmap_cs_source24.vcd	At Extended A.
/tmap_cs_source25.vcd	Hole.
/tmap_cs_source26.vcd	Checking the Hole.
/tmap_cs_source28.vcd	At the Hole.
/tmap_cs_source32.vcd	Long A.
/tmap_cs_source33.vcd	Checking the Long A.
/tmap_cs_source34.vcd	At Long A.
/tmap_cs_source35.vcd	Long Doors.
/tmap_cs_source36.vcd	Checking the Long Doors.
/tmap_cs_source37.vcd	At Long Doors.
/tmap_cs_source41.vcd	Mid Doors.
/tmap_cs_source42.vcd	Checking the Mid Doors.
/tmap_cs_source43.vcd	At the Mid Doors.
/tmap_cs_source53.vcd	Short Stairs.
/tmap_cs_source54.vcd	Checking the Short Stairs.
/tmap_cs_source55.vcd	At the Short Stairs.
/tmap_cs_source62.vcd	Our Ramp.
/tmap_cs_source63.vcd	Checking our Ramp.
/tmap_cs_source65.vcd	Top of Mid.
/tmap_cs_source66.vcd	Checking the Top of Mid.
/tmap_cs_source67.vcd	At Top of Mid.
/tmap_cs_source71.vcd	Under A.
/tmap_cs_source73.vcd	At Under A.
/tmap_cs_source74.vcd	Upper Tunnel.
/tmap_cs_source75.vcd	Checking the Upper Tunnel.
/tmap_de_aztec01.vcd	Back.
/tmap_de_aztec02.vcd	I'm in the Back.
/tmap_de_aztec03.vcd	I'm checking the Back.
/tmap_de_aztec04.vcd	The Bridge
/tmap_de_aztec05.vcd	I'm on the Bridge.
/tmap_de_aztec07.vcd	Bridge.
/tmap_de_aztec08.vcd	Double Doors.
/tmap_de_aztec09.vcd	Double Doors, Double Doors.
/tmap_de_aztec10.vcd	Going through the Double Doors.
/tmap_de_aztec11.vcd	Overpass.
/tmap_de_aztec12.vcd	On the Overpass.
/tmap_de_aztec13.vcd	Checking the Overpass.
/tmap_de_bank01.vcd	Back Yard.
/tmap_de_bank02.vcd	Checking the Back Yard.
/tmap_de_bank03.vcd	In the Back Yard.
/tmap_de_dust01.vcd	Back Alley.
/tmap_de_dust02.vcd	Checking the Back Alley.
/tmap_de_dust03.vcd	In the Back Alley.
/tmap_de_dust04.vcd	Back Alleys.
/tmap_de_dust05.vcd	Checking the Back Alleys.
/tmap_de_dust06.vcd	At the Back Alleys.
/tmap_de_dust07.vcd	Back Entrance.
/tmap_de_dust08.vcd	At the Back Entrance.
/tmap_de_dust09.vcd	By the Back Entrance.
/tmap_de_dust10.vcd	At their Landing Zone.
/tmap_de_dust11.vcd	Checking their Landing Zone.
/tmap_de_dust12.vcd	By their Landing Zone.
/tmap_de_dust13.vcd	Front.
/tmap_de_dust14.vcd	At the Front.
/tmap_de_dust15.vcd	Checking the Front.
/tmap_de_dust17.vcd	Front Entrance.
/tmap_de_dust18.vcd	I'm at the Front Entrance.
/tmap_de_dust19.vcd	By the Front Entrance.
/tmap_de_dust20.vcd	Palace Interior.
/tmap_de_dust21.vcd	Inside the Palace.
/tmap_de_dust23.vcd	Checking inside the Palace.
/tmap_de_dust24.vcd	Side.
/tmap_de_dust25.vcd	At the Side.
/tmap_de_dust26.vcd	Checking the Side.
/tmap_de_dust27.vcd	Side Entrance.
/tmap_de_dust28.vcd	I'm checking the Side Entrance.
/tmap_de_dust29.vcd	I'm at the Side Entrance.
/tmap_de_dust30.vcd	Back at our Start.
/tmap_de_dust31.vcd	At our Start Point.
/tmap_de_dust32.vcd	Checking our Start Point.
/tmap_de_dust33.vcd	Underpass.
/tmap_de_dust34.vcd	Taking the Underpass.
/tmap_de_dust35.vcd	At the Underpass.
/TwoEnemiesLeft01.vcd	They are down to two.
/TwoEnemiesLeft02.vcd	Only two men left.
/TwoEnemiesLeft03.vcd	2 men left.
/TwoEnemiesLeft04.vcd	That makes two left.
/TwoEnemiesLeft05.vcd	That makes two.
/WaitingHere01.vcd	I'm waiting here.
/WaitingHere02.vcd	I'll wait here.
/WaitingHere03.vcd	I shall stay here.