/Affirmative01.vcd	Roger that.
/Affirmative02.vcd	Roger that, Boss.
/Affirmative03.vcd	Roger.
/Affirmative05.vcd	Yes!
/Affirmative07.vcd	Affirmative!
/Affirmative09.vcd	Roger that!
/Agree01.vcd	Alright.
/Agree02.vcd	Okay.
/Agree03.vcd	Sounds good.
/Blinded01.vcd	Blinded!
/Blinded02.vcd	Can't see!
/Blinded03.vcd	Blind!
/BombsiteClear01.vcd	Bombsite secure.
/BombsiteClear02.vcd	Bombsite safe.
/BombsiteClear03.vcd	Bombsite under control.
/BombTickingDown01.vcd	That bomb's ticking down.
/BombTickingDown03.vcd	Let's take care of that bomb.
/ClearedArea01.vcd	All clear.
/ClearedArea02.vcd	Clear.
/ClearedArea03.vcd	We're clear.
/ClearedArea04.vcd	Area secure.
/CommanderDown01.vcd	Commander down! Commander down!
/CommanderDown02.vcd	We lost the commander!
/CommanderDown03.vcd	Commander down!
/CoveringFriend01.vcd	I've got your back.
/CoveringFriend02.vcd	I've got you.
/CoveringFriend03.vcd	Covering.
/CoveringFriend04.vcd	Covering!
/CoverMe01.vcd	Cover me.
/CoverMe02.vcd	Cover.
/CoverMe03.vcd	Hold up, cover me.
/ct_bombexploding01.vcd	Oh crap...
/ct_bombexploding02.vcd	Get back! Get BACK!
/ct_bombexploding03.vcd	Run! Run!
/ct_bombexploding04.vcd	CLEAR THE AREA!
/ct_bombexploding05.vcd	Too late run!
/ct_bombexploding06.vcd	Oh, Schei√üe! (Oh, Crap!)
/ct_bombexploding07.vcd	Too late, Lauf! (Too late, Run!)
/ct_death01.vcd	Ahhhh!
/ct_death02.vcd	Ohhhmmmph.
/ct_death03.vcd	(exhale)
/ct_decoy01.vcd	Decoy!
/ct_decoy02.vcd	Decoy's out.
/ct_decoy03.vcd	Deploying decoy.
/ct_flashbang01.vcd	Flashbang.
/ct_flashbang02.vcd	Deploying Flashbang.
/ct_flashbang03.vcd	Throwing Flashbang.
/ct_grenade01.vcd	Fire in the hole!
/ct_grenade02.vcd	Grenade out!
/ct_grenade03.vcd	Throwing a grenade.
/ct_grenade06.vcd	Granate! (Grenade!)
/ct_molotov01.vcd	Incendiary out!
/ct_molotov02.vcd	Throwing fire.
/ct_molotov03.vcd	Incendiary!
/ct_smoke01.vcd	Smoke!
/ct_smoke02.vcd	Throwing smoke.
/ct_smoke03.vcd	Laying down smoke.
/ctmap_cs_source19.vcd	Back Entrance.
/ctmap_cs_source20.vcd	Checking the Back Entrance.
/ctmap_cs_source21.vcd	At the Back Entrance.
/ctmap_cs_source22.vcd	Hintereingang. (Back Entrance.)
/ctmap_cs_source23.vcd	Am Hintereingang. (At the Back Entrance.)
/ctmap_cs_source61.vcd	At their Entry Point.
/ctmap_cs_source62.vcd	Checking their Entry Point.
/ctmap_cs_source63.vcd	I'm at their Entry Point.
/ctmap_cs_source79.vcd	Insertion Point.
/ctmap_cs_source81.vcd	Back at the Insertion Point.
/ctmap_cs_source82.vcd	I'm at our Insertion Point.
/ctmap_cs_source106.vcd	Middle.
/ctmap_cs_source107.vcd	At the Middle.
/ctmap_cs_source108.vcd	In the Middle.
/ctmap_cs_source167.vcd	Tunnel.
/ctmap_cs_source168.vcd	Taking the Tunnel.
/ctmap_cs_source169.vcd	In the Tunnel.
/DefusingBomb01.vcd	Defusing!
/DefusingBomb02.vcd	I'm defusing the bomb.
/DefusingBomb03.vcd	Defusing the bomb.
/DefusingBomb04.vcd	Defusing.
/Disagree01.vcd	No.
/Disagree02.vcd	That's a negative.
/Disagree04.vcd	Ah.. No.
/EnemyDown01.vcd	Got one!
/EnemyDown02.vcd	He's down.
/EnemyDown03.vcd	Dropped him.
/EnemyDown04.vcd	Got 'em.
/EnemyDown05.vcd	Got one.
/EnemyDown06.vcd	He's down!
/EnemyDown07.vcd	Dropped him!
/EnemyDown08.vcd	He's not getting back up.
/FollowingFriend01.vcd	Lead.
/FollowingFriend02.vcd	Lead the way.
/FollowingFriend04.vcd	I'm with you.
/FollowingFriend05.vcd	Go ahead and lead.
/FriendlyFire01.vcd	That better have been a mistake.
/FriendlyFire02.vcd	Secure that weapon!
/FriendlyFire03.vcd	Watch the friendly fire!
/FriendlyFire04.vcd	Hold your fire!
/FriendlyFire05.vcd	Hold your fire! Hold your fire!
/FriendlyFire06.vcd	Yourself together, man.
/GoingToGuardLooseBomb01.vcd	Heading to the dropped bomb.
/GoingToGuardLooseBomb02.vcd	Going to cover the dropped bomb.
/GoingToGuardLooseBomb03.vcd	Heading to the bomb.
/GuardingLooseBomb01.vcd	Guarding the dropped bomb.
/GuardingLooseBomb02.vcd	I'm staying with bomb.
/GuardingLooseBomb03.vcd	Covering the bomb.
/HeardNoise01.vcd	I think I heard something.
/HeardNoise02.vcd	Did you hear that?
/HeardNoise03.vcd	Anyone else hear that?
/Help01.vcd	I need help!
/Help02.vcd	Could use some help.
/Help03.vcd	Need help!
/HostageDown01.vcd	Hostage down!
/HostageDown02.vcd	Hostage down! Hostage down!
/HostageDown03.vcd	We're losing Hostages!
/HostageDown04.vcd	They're killing Hostages!
/HostageDown05.vcd	Protect the Hostages!
/InCombat01.vcd	Attacking!
/InCombat02.vcd	Weapons hot!
/InCombat03.vcd	Opening up!
/InCombat04.vcd	Firing!
/InCombat05.vcd	Have at it!
/InCombat06.vcd	Letting go!
/InCombat08.vcd	Throwing lead!
/InPosition01.vcd	I'm in position.
/InPosition02.vcd	I'm ready.
/InPosition03.vcd	In position.
/KilledFriend01.vcd	What the hell is going on?
/KilledFriend02.vcd	What are you guys doing?
/KilledFriend03.vcd	He was one of ours!
/KilledFriend04.vcd	Whose team are you on?
/KilledFriend05.vcd	That does not happen in my squad.
/LastManStanding01.vcd	Guys, I did that for you.
/LastManStanding02.vcd	No one's getting me!
/LastManStanding04.vcd	That's right, that's right!
/LastManStanding05.vcd	I'm still alive.
/LastManStanding08.vcd	This is over.
/LostEnemy01.vcd	Lost 'em.
/LostEnemy02.vcd	They got away.
/LostEnemy03.vcd	I lost 'em.
/Negative01.vcd	Negative.
/Negative02.vcd	Negative.
/Negative03.vcd	Ah.. No.
/Negative04.vcd	That's a negative.
/NiceShot01.vcd	Nice shot!
/NiceShot02.vcd	Good one.
/NiceShot03.vcd	Good kill!
/NiceShot04.vcd	Way to go.
/NiceShot05.vcd	Nice shot.
/NiceShot06.vcd	Good one.
/NiceShot07.vcd	Clean kill!
/NiceShot08.vcd	You got it.
/NoEnemiesLeft01.vcd	We got 'em all.
/NoEnemiesLeft02.vcd	None left.
/NoEnemiesLeft03.vcd	Just us left.
/NoEnemiesLeft04.vcd	Nice job, they're all dead.
/NoEnemiesLeft05.vcd	They're all dead.
/NoEnemiesLeftBomb01.vcd	We got 'em all, let's defuse that bomb.
/NoEnemiesLeftBomb02.vcd	We still got a bomb to defuse.
/NoEnemiesLeftBomb03.vcd	Let's take care of that bomb now.
/NoEnemiesLeftBomb04.vcd	We got 'em but that bomb's ticking.
/OnARollBrag01.vcd	Oh yeah!
/OnARollBrag02.vcd	All right!
/OnARollBrag03.vcd	That's the way we do it.
/OnARollBrag04.vcd	There ya go.
/OnARollBrag05.vcd	Nice.
/OnARollBrag06.vcd	We are doing this!
/OnARollBrag07.vcd	No stopping us.
/OnARollBrag08.vcd	All right! All right!
/OnARollBrag09.vcd	We got this.
/OneEnemyLeft01.vcd	1 guy left.
/OneEnemyLeft02.vcd	Only one guy left.
/OneEnemyLeft03.vcd	We have one lone bad guy.
/OneEnemyLeft06.vcd	Only one guy left.
/OneEnemyLeft08.vcd	That makes one.
OnMyWay01.vcd	On my way.
OnMyWay02.vcd	Coming.
OnMyWay03.vcd	Heading over.
PepTalk01.vcd	We can do this.
PepTalk03.vcd	Let's get our heads in the game.
PepTalk04.vcd	We can still do this.
PinnedDown01.vcd	I'm pinned down!
PinnedDown02.vcd	I'm pinned!
PinnedDown03.vcd	Help, I'm pinned!
PlantedBombPlaceSafe01.vcd	They planted the bomb at the safe.
PlantedBombPlaceSafe02.vcd	The bomb is at the safe.
PlantedBombPlaceSafe03.vcd	They're going to blow the safe.
/Radio_EnemySpotted02.vcd	Targets acquired.
/Radio_EnemySpotted03.vcd	Targets acquired.
/Radio_EnemySpotted04.vcd	I have eyes on the enemy.
/Radio_EnemySpotted05.vcd	Target spotted.
/Radio_FollowMe01.vcd	Follow me.
/Radio_FollowMe02.vcd	Stack up on me.
/Radio_FollowMe03.vcd	I'll lead.
/Radio_FollowMe04.vcd	I'll take point.
/Radio_FollowMe05.vcd	On me.
/radio_letsgo01.vcd	Go! Go! Go!
/radio_letsgo02.vcd	Go, go, go!
/radio_letsgo03.vcd	Move it, move it!
/radio_letsgo04.vcd	Move it! Move it!
/radio_letsgo05.vcd	Let's go! Let's go!
/radio_letsgo06.vcd	Los, los, los!
/radio_letsgo07.vcd	Los! Los! Los!
/Radio_NeedBackup01.vcd	Need support.
/Radio_NeedBackup02.vcd	Need backup.
/Radio_NeedBackup03.vcd	Need backup now!
/Radio_TakingFire01.vcd	I'm under fire!
/Radio_TakingFire02.vcd	Under fire!
/Radio_TakingFire03.vcd	Contact! Contact!
/Radio_TakingFire04.vcd	Needs assistance!
/Radio_TakingFire05.vcd	I'm in trouble!
/Radio_TakingFire06.vcd	I'm in big trouble!
/Radio_TakingFire07.vcd	Taking fire!
/RadioBotEndClean01.vcd	Good job, we're all going home tonight.
/RadioBotEndClean02.vcd	Good job everyone!
/RadioBotEndClean03.vcd	Nice work everyone.
/RadioBotEndClean04.vcd	Nice work, smoke 'em if you got 'em.
/RadioBotEndClose01.vcd	That was close.
/RadioBotEndClose02.vcd	We barely stopped them.
/RadioBotEndClose03.vcd	That was a close one.
/RadioBotEndClose04.vcd	That was a little too close.
/RadioBotEndSolid01.vcd	Good job, men.
/RadioBotEndSolid02.vcd	Nice work!
/RadioBotEndSolid03.vcd	We did it.
/RadioBotEndSolid04.vcd	We're going home!
/RadioBotFallBack01.vcd	Fall back!
/RadioBotFallBack02.vcd	Team fall back!
/RadioBotFallBack03.vcd	BACK! BACK!
/RadioBotHold01.vcd	Hold this position.
/RadioBotHold02.vcd	Cover this area.
/RadioBotHold03.vcd	Stay here.
/RadioBotHostagesEscort01.vcd	Escorting the Hostages.
/RadioBotHostagesEscort02.vcd	I'm bringing the Hostages out.
/RadioBotHostagesEscort03.vcd	Hostages coming out.
/RadioBotRegroup01.vcd	Regroup.
/RadioBotRegroup02.vcd	Stick together.
/RadioBotRegroup03.vcd	Form up.
/RadioBotRegroup04.vcd	Pull yourselves together.
/radiobotreponsenegative01.vcd	No.
/RadioBotTime01.vcd	Hurry up!
/RadioBotTime02.vcd	Time's running out!
/RadioBotTime03.vcd	We don't have much time!
/RadioBotWait01.vcd	Wait here.
/ReportingIn01.vcd	Reporting In.
/ReportingIn02.vcd	Checking In.
/ReportingIn03.vcd	Reporting In.
/RequestReport01.vcd	Status?
/RequestReport02.vcd	Report In.
/RequestReport03.vcd	Check in.
/ScaredEmote01.vcd	Oh man oh man...
/ScaredEmote02.vcd	I'm gettin' worried.
/ScaredEmote03.vcd	This is going bad.
/ScaredEmote04.vcd	This is not going well.
/ScaredEmote05.vcd	Das sieht nicht gut aus. (That doesn't look good.)
/SniperKilled01.vcd	Sniper down!
/SniperKilled02.vcd	Got the sniper!
/SniperKilled03.vcd	Sniper down!
/SniperWarning01.vcd	Sniper!
/SniperWarning02.vcd	Sniper! Sniper!
/SniperWarning03.vcd	Watch out, sniper!
/SpottedBomber01.vcd	He's got the bomb.
/SpottedBomber02.vcd	Spotted the bomb carrier.
/SpottedBomber03.vcd	I see the bomb carrier.
/SpottedBomber04.vcd	Bomb carrier spotted.
/SpottedBomber05.vcd	Bomb carrier down range.
/SpottedLooseBomb01.vcd	The bomb has been dropped.
/SpottedLooseBomb02.vcd	They dropped the bomb.
/SpottedLooseBomb03.vcd	The bomb is on the ground.
/SpottedLooseBomb04.vcd	The bomb has been dropped. Repeat. The bomb has been dropped.
/SpottedLooseBomb05.vcd	The bomb is down. The bomb is down.
/Thanks01.vcd	Thanks.
/Thanks03.vcd	Thanks!
/Thanks04.vcd	Danke! (Thanks!)
/Thanks07.vcd	Vielen Dank! (Thank you very much!)
/TheyPickedUpTheBomb01.vcd	They've got the bomb.
/TheyPickedUpTheBomb02.vcd	They picked up the bomb.
/TheyPickedUpTheBomb03.vcd	They've recovered the bomb.
/ThreeEnemiesLeft01.vcd	3 guys left.
/ThreeEnemiesLeft02.vcd	That makes three.
/ThreeEnemiesLeft04.vcd	3 to go.
/TwoEnemiesLeft01.vcd	2 guys left.
/TwoEnemiesLeft02.vcd	They're down to two.
/TwoEnemiesLeft03.vcd	2 bad guys left.
/TwoEnemiesLeft04.vcd	2 guys left.
/TwoEnemiesLeft05.vcd	That makes 2 left.
/WaitingForHumanToDefuseBomb01.vcd	Covering while you defuse.
/WaitingForHumanToDefuseBomb02.vcd	Defuse the bomb and I'll cover you.
/WaitingForHumanToDefuseBomb03.vcd	Go ahead and defuse the bomb.
/WaitingForHumanToDefuseBomb04.vcd	Get the bomb, get the bomb!
/WaitingHere01.vcd	I'm waiting here.
/WaitingHere02.vcd	Waiting here.
/WaitingHere03.vcd	Staying here.
/WhereIsTheBomb01.vcd	Where's the bomb?
/WhereIsTheBomb02.vcd	Anyone see the bomb?